F 0,000,000000000000000
C 25,250,250

NO ./path_to_the_north_texture		
SO ./path_to_the_south_texture
WE ./path_to_the_west_texture
EA ./path_to_the_east_texture

11111111111111111111111111
1N00000000110000000000001
1000000011100000000000011111
100100000000000000000000111111111
111111111011000001110000000000001
100000000011000001110111111111111
1111011111111101110000001001
11110111111111011101010010001
11000000110101011100000010001
10000000000000001100000010001
10000000000000001101010010001
1100000111010101111101111000111
11110111 1110101 101111010001
11111111 1111111 111111111111
