11111111111111111111
11100001001100000001
10110000011100000001
10010001000000000001
10010001000000000001
10010000000000000001
10010000000000000001
10000001100000000011
10010001000000000001
10010001000000000001
1S111111101100000001
11111111111111111111