11111111111111111111
11100000001100000001
10110000011100000001
10010000000000000001
111111111N1100000101
11111111111111111111