F 255,255,255
C 255,255,255

NO ./path_to_the_north_texture		
SO ./path_to_the_south_texture
WE ./path_to_the_west_texture
EA ./path_to_the_east_texture

11111111111111111111
10000000000000000001
11000000000000000001
10000000000000000001
10000000000000000001
10000000000000000001
100000000N1000000001
10000000010000000011
10000000001000000001
10000000000000000001
10000000000000000001
11111111111111111111
