F 215,25,25
C 25,25,25

NO ./textures/north.xpm	
SO ./textures/south.xpm
WE ./textures/west.xpm
EA ./textures/east.xpm

11111111111111111111111
10000000000000000001111
10000000001000000001111
100010000000N0000001111
10000001000100000001111
10000000000000000001111
10001000000000000001111
10000000000000000001111
10000000000000000001111
10000000000000000001111
10000000000000000000001
10000000000000000000001
10000000000000000000001
10000000000000000000001
10000000000000000000001
10000000000000000001111
10000000000000000001111
10000000000000000000001
10000000000000000000001
10000000000000000000001
10000000000000000000001
10000000000000000000001
10000000000000000001111
10000000000000000001111
10000000000000000000001
10000000000000000001111
10000000000000000001111
10000000000000000001111
10000000000000000000001
10000000000000000000001
10000000000000000000001
10000000000000000000001
10000000000000000000001
10000000000000000001111
10000000000000000001111
10000000000000000000001
10000000000000000000001
10000000000000000000001
10000000000000000000001
10000000000000000000001
10000000000000000001111
10000000000000000001111
10000000000000000000001
10000000000000000001111
10000000000000000001111
10000000000000000001111
10000000000000000000001
10000000000000000000001
10000000000000000000001
10000000000000000000001
10000000000000000000001
10000000000000000001111
10000000000000000001111
10000000000000000000001
10000000000000000000001
10000000000000000000001
10000000000000000000001
10000000000000000000001
10000000000000000001111
10000000000000000001111
10000000000000000000001
10000000000000000001111
10000000000000000001111
10000000000000000001111
10000000000000000000001
10000000000000000000001
10000000000000000000001
10000000000000000000001
10000000000000000000001
10000000000000000001111
10000000000000000001111
10000000000000000000001
10000000000000000000001
10000000000000000000001
10000000000000000000001
10000000000000000000001
10000000000000000001111
10000000000000000001111
10000000000000000000001
10000000000000000001111
10000000000000000001111
10000000000000000001111
10000000000000000000001
10000000000000000000001
10000000000000000000001
10000000000000000000001
10000000000000000000001
10000000000000000001111
10000000000000000001111
10000000000000000000001
10000000000000000000001
10000000000000000000001
10000000000000000000001
10000000000000000000001
10000000000000000001111
10000000000000000001111
10000000000000000000001
10000000000000000001111
10000000000000000001111
10000000000000000001111
10000000000000000000001
10000000000000000000001
10000000000000000000001
10000000000000000000001
10000000000000000000001
10000000000000000001111
10000000000000000001111
10000000000000000000001
10000000000000000000001
10000000000000000000001
10000000000000000000001
10000000000000000000001
10000000000000000001111
10000000000000000001111
10000000000000000000001
10000000000000000001111
10000000000000000001111
10000000000000000001111
10000000000000000000001
10000000000000000000001
10000000000000000000001
10000000000000000000001
10000000000000000000001
10000000000000000001111
10000000000000000001111
10000000000000000000001
10000000000000000000001
10000000000000000000001
10000000000000000000001
10000000000000000000001
10000000000000000001111
10000000000000000001111
10000000000000000000001
10000000000000000001111
10000000000000000001111
10000000000000000001111
10000000000000000000001
10000000000000000000001
10000000000000000000001
10000000000000000000001
10000000000000000000001
10000000000000000001111
10000000000000000001111
10000000000000000000001
10000000000000000000001
10000000000000000000001
10000000000000000000001
10000000000000000000001
10000000000000000001111
10000000000000000001111
10000000000000000000001
10000000000000000001111
10000000000000000001111
10000000000000000001111
10000000000000000000001
10000000000000000000001
10000000000000000000001
10000000000000000000001
10000000000000000000001
10000000000000000001111
10000000000000000001111
10000000000000000000001
10000000000000000000001
10000000000000000000001
10000000000000000000001
10000000000000000000001
10000000000000000001111
10000000000000000001111
10000000000000000000001
10000000000000000001111
10000000000000000001111
10000000000000000001111
10000000000000000000001
10000000000000000000001
10000000000000000000001
10000000000000000000001
10000000000000000000001
10000000000000000001111
10000000000000000001111
10000000000000000000001
10000000000000000000001
10000000000000000000001
10000000000000000000001
10000000000000000000001
10000000000000000001111
10000000000000000001111
10000000000000000000001
10000000000000000001111
10000000000000000001111
10000000000000000001111
10000000000000000000001
10000000000000000000001
10000000000000000000001
10000000000000000000001
10000000000000000000001
10000000000000000001111
10000000000000000001111
10000000000000000000001
10000000000000000000001
10000000000000000000001
10000000000000000000001
10000000000000000000001
10000000000000000001111
10000000000000000001111
10000000000000000000001
11111111111111111111111
