F 255,255,255
C 255,255,255

NO ./path_to_the_north_texture		
SO ./path_to_the_south_texture
WE ./path_to_the_west_texture
EA ./path_to_the_east_texture
        


11111111111111111111
111S0001001100000001
10110000011100000001
10010001000000000001
10010001000000000001
10010000000000000001
10010000000000000001
10000001000000000011
10010001000000000001
10010001000000000001
11111111101100000001
11111111111111111111