F 255,255,225
C 255,255,255

NO ./path_to_the_north_texture		
SO ./path_to_the_south_texture
WE ./path_to_the_west_texture
EA ./path_to_the_east_texture

11111111111111111111
10000000000000000001
10000000101000000001
10000000000100000001
10000010000010000001 
10000100000001000001
10001000N00000100001
10010000000000010001
10100000000000001001
10000000000000000101
10000000000000000001
11111111111111111111
