F 255,255,255
C 255,255,255

NO ./path_to_the_north_texture		
SO ./path_to_the_south_texture
WE ./path_to_the_west_texture
EA ./path_to_the_east_texture

    1111111111111111111111111111111111111111111111111111111111111111111111111111111111111111111111111111111111
    101 101 101 101 101 101 101 101 101 101 101 101 101 101 101 101 101 101 101 101 101 1000000000000111111111
   10001000100010001000100010001000100010001000100010001000100010001000100010001000100010000110001100000000001
  100000000000000000000000000000000000000000000000000000000000000000000000000000000000000001  101  10000000001
 10011110001100001100011110001111111000111111111000111110001100001100011111100000000000000001  1  100000000011
1001    101  1001  101    101       101         101     101  1001  101      100000000000000001   1000000000001
1101   1101  1001  101  11101  11111001   111   101  111101  1001  10011  110000000000000000001 10000000000011
1001  10001  1001  101  10001  10000001   1 1   101  100001  1001  10001  100111001110111011100100111101110001
1101  10001  1111  101  11101  10000001   111   101  111001  1111  10001  100101000010001010100000100101000001
1001  10001        101    101  10111101         101     101        10001  100001001110111000101110111001011001
1101  10001  1111  101  11101  101  101  11111  1001111 101  1111  10001  100001000010001000100000100101001001
1001  10001  1001  101  10001  1001 101  10001  1000001 101  1001  10001  100011101110111000100000111001111001
1101   1101  1001  101  11101  1111 101  10001  1011111 101  1001  10011  100000000000000000000000000000000001
1001    101  1001  101    101       101  10001  101     101  1001  101     11000101010101010101010101010100001
11001111000110001110001111000111111100011000011100011111000110000110001111110011111111111111111111111111111101   
110000000000000000000000000000000000000000000000000000S00000000000000000000001                             101
 11000000000000000000000000000000000000000000000000010100000000000000000000001                             101
  1100000000001100110111100100010111011101000100100111101001001111000000000001                             101
   110000000011001100000110110010100001001000101 10101001010011000000000000001                             101
    10000000110011000001100101010111001001010101 10110001100001100000000000001                             101
     1100001111110011111000100110100001001101101 10101001010000111110000000001                             101
      110000001100110000000100010111001000101000100100101001000000011000000011                             101
       11000011000110000000000000000000000000000000000000000000000011000000001                             101
        1100110000111111111111111111111111111111111111111111111111111000000011                             101
         10000000000000000000000000000000000000000000000000000000000000000000111111111111111111111111111111101
          1111111111111111111111111111111111111111111111111111111111111000000000000000000000000000000000000001  
           111111111111111111111111111111111111111111111111111111111111111111111111111111111111111111111111111