F 0,0,0
C 102,25,25

NO ./path_to_the_north_texture		
SO ./path_to_the_south_texture
WE ./path_to_the_west_texture
EA ./path_to_the_east_texture

1111111111111111111111111111
1N00000000000000000000000001
1000000000000000000010000001
1010010000000000000000000001
1010000000000000000000000001
1010000000000100000000000001
1010000000000000000000000001
1010000000100000000000000001
1010000000000000000010000001
1010000000000000000000000001
1010000000000000010000000001
1010000000000000000000000001
1111111111111111111111111111